time,BC+,BC-,BC,total,BC/total,BCfresh,BCaged,fresh/total,aged/total
2021/5/1 0:00,262,1447,1469,6506,0.225791577,70,1399,0.010759299,0.215032278
2021/5/1 1:00,718,4467,4568,19633,0.232669485,132,4436,0.006723374,0.225946111
2021/5/1 2:00,768,4155,4285,18477,0.231909942,168,4117,0.009092385,0.222817557
2021/5/1 3:00,750,3518,3619,17538,0.206351922,173,3446,0.009864295,0.196487627
2021/5/1 4:00,906,3692,3863,18778,0.205719459,303,3560,0.016135904,0.189583555
2021/5/1 5:00,966,3199,3377,16576,0.203728282,236,3141,0.014237452,0.18949083
2021/5/1 6:00,747,2448,2575,13632,0.188893779,205,2370,0.015038146,0.173855634
2021/5/1 7:00,748,2267,2406,13839,0.173856493,179,2227,0.012934461,0.160922032
2021/5/1 8:00,594,1713,1826,10889,0.167692166,150,1676,0.01377537,0.153916797
2021/5/1 9:00,805,2269,2460,13730,0.179169701,172,2288,0.012527312,0.166642389
2021/5/1 10:00,885,2302,2505,14396,0.174006669,252,2253,0.017504862,0.156501806
2021/5/1 11:00,638,2571,2650,13522,0.195976926,367,2283,0.027140955,0.168835971
2021/5/1 12:00,531,2774,2835,14772,0.191917141,459,2376,0.031072299,0.160844842
2021/5/1 13:00,627,2852,2936,14551,0.201773074,368,2568,0.025290358,0.176482716
2021/5/1 14:00,605,2806,2880,14526,0.19826518,357,2523,0.024576621,0.173688558
2021/5/1 15:00,564,2757,2846,13246,0.214857315,380,2466,0.028687906,0.18616941
2021/5/1 16:00,550,2946,3035,14856,0.204294561,487,2548,0.032781368,0.171513193
2021/5/1 17:00,594,3059,3151,16184,0.194698468,594,2557,0.036702916,0.157995551
2021/5/1 18:00,518,2394,2474,11541,0.214366173,429,2045,0.037171822,0.177194351
2021/5/1 19:00,406,2153,2219,11490,0.193124456,221,1998,0.019234117,0.173890339
2021/5/1 20:00,457,2117,2164,10495,0.206193425,172,1992,0.016388757,0.189804669
2021/5/1 21:00,411,2585,2622,12586,0.208326712,161,2461,0.012791991,0.195534721
2021/5/1 22:00,517,4188,4243,17963,0.23620776,169,4074,0.009408228,0.226799532
2021/5/1 23:00,692,4815,4899,20970,0.233619456,234,4665,0.011158798,0.222460658
2021/5/2 0:00,721,4709,4769,20276,0.235204182,172,4597,0.008482935,0.226721247
2021/5/2 1:00,689,4307,4379,19041,0.229977417,177,4202,0.00929573,0.220681687
2021/5/2 2:00,667,3694,3766,17096,0.220285447,112,3654,0.00655124,0.213734207
2021/5/2 3:00,592,3015,3087,15380,0.200715215,99,2988,0.006436931,0.194278283
2021/5/2 4:00,488,2397,2468,12976,0.190197287,59,2409,0.004546856,0.185650432
2021/5/2 5:00,467,1766,1831,10147,0.180447423,90,1741,0.008869617,0.171577806
2021/5/2 6:00,407,1404,1451,9211,0.157529041,85,1366,0.009228097,0.148300945
2021/5/2 7:00,355,1292,1341,9035,0.1484228,79,1262,0.008743774,0.139679026
2021/5/2 8:00,452,1643,1693,10979,0.154203479,190,1503,0.017305766,0.136897714
2021/5/2 9:00,370,1881,1924,11010,0.174750227,204,1720,0.01852861,0.156221617
2021/5/2 10:00,503,2508,2558,11724,0.21818492,340,2218,0.029000341,0.189184579
2021/5/2 11:00,392,2448,2477,11194,0.221279257,454,2023,0.040557441,0.180721815
2021/5/2 12:00,397,2422,2451,11924,0.205551828,317,2134,0.026585039,0.17896679
2021/5/2 13:00,361,2046,2076,11198,0.185390248,368,1708,0.032863011,0.152527237
2021/5/2 14:00,428,2572,2604,11720,0.2221843,462,2142,0.039419795,0.182764505
2021/5/2 15:00,311,1911,1940,9746,0.199056023,326,1614,0.03344962,0.165606403
2021/5/2 16:00,338,1808,1829,9373,0.195134962,344,1485,0.036701163,0.158433799
2021/5/2 17:00,402,1627,1659,8553,0.193967029,124,1535,0.014497837,0.179469192
2021/5/2 18:00,499,1680,1718,8532,0.201359587,117,1601,0.01371308,0.187646507
2021/5/2 19:00,444,1628,1643,7657,0.214574899,109,1534,0.01423534,0.200339559
2021/5/2 20:00,450,1806,1821,7977,0.228281309,104,1717,0.013037483,0.215243826
2021/5/2 21:00,300,1961,1966,9232,0.212954939,128,1838,0.013864818,0.199090121
2021/5/2 22:00,203,3380,3386,13019,0.260081419,91,3295,0.006989784,0.253091635
2021/5/2 23:00,297,4408,4427,17851,0.247997311,111,4316,0.006218139,0.241779172
2021/5/3 0:00,324,4913,4929,19596,0.251530925,136,4793,0.006940192,0.244590733
2021/5/3 1:00,335,3708,3730,15690,0.237731039,68,3662,0.004333971,0.233397068
2021/5/3 2:00,277,3250,3273,13030,0.251189563,86,3187,0.006600153,0.244589409
2021/5/3 3:00,199,2839,2847,11082,0.256903086,59,2788,0.005323949,0.251579137
2021/5/3 4:00,229,2699,2717,10170,0.267158309,102,2615,0.010029499,0.25712881
2021/5/3 5:00,273,2720,2752,10157,0.270946146,91,2661,0.008959338,0.261986807
2021/5/3 6:00,176,1639,1654,6810,0.24287812,117,1537,0.017180617,0.225697504
2021/5/3 7:00,166,835,854,4598,0.185732927,124,730,0.026968247,0.15876468
2021/5/3 8:00,158,677,691,4386,0.15754674,91,600,0.020747834,0.136798906
2021/5/3 9:00,141,655,666,4137,0.160986222,162,504,0.039158811,0.121827411
2021/5/3 10:00,118,697,706,4199,0.16813527,234,472,0.055727554,0.112407716
2021/5/3 11:00,115,586,594,4044,0.146884273,205,389,0.050692384,0.096191889
2021/5/3 12:00,83,575,584,3932,0.148524924,149,435,0.037894201,0.110630722
2021/5/3 13:00,129,628,640,4210,0.152019002,125,515,0.029691211,0.122327791
2021/5/3 14:00,107,563,570,3851,0.148013503,120,450,0.031160737,0.116852766
2021/5/3 15:00,100,625,631,3562,0.17714767,155,476,0.043514879,0.133632791
2021/5/3 16:00,95,580,585,3738,0.156500803,118,467,0.031567683,0.124933119
2021/5/3 17:00,100,578,587,4107,0.14292671,129,458,0.031409788,0.111516922
2021/5/3 18:00,110,635,641,4199,0.152655394,133,508,0.031674208,0.120981186
2021/5/3 19:00,104,704,718,4439,0.161748141,126,592,0.028384771,0.13336337
2021/5/3 20:00,91,852,857,5027,0.170479411,150,707,0.02983887,0.140640541
2021/5/3 21:00,104,857,867,5637,0.153805216,124,743,0.021997516,0.131807699
2021/5/3 22:00,101,633,643,5173,0.124299246,84,559,0.01623816,0.108061086
2021/5/3 23:00,91,638,646,4405,0.146651532,83,563,0.018842225,0.127809308
2021/5/4 0:00,66,644,644,4203,0.153223888,71,573,0.016892696,0.136331192
2021/5/4 1:00,82,646,658,3906,0.168458781,120,538,0.030721966,0.137736815
2021/5/4 2:00,108,759,763,4267,0.178814155,124,639,0.02906023,0.149753925
2021/5/4 3:00,112,777,782,4202,0.186101856,126,656,0.029985721,0.156116135
2021/5/4 4:00,109,776,780,3936,0.198170732,122,658,0.030995935,0.167174797
2021/5/4 5:00,123,802,810,3970,0.204030227,138,672,0.034760705,0.169269521
2021/5/4 6:00,134,836,843,3954,0.213201821,192,651,0.048558422,0.164643399
2021/5/4 7:00,126,819,820,4032,0.203373016,206,614,0.05109127,0.152281746
2021/5/4 8:00,156,987,992,4211,0.235573498,285,707,0.067679886,0.167893612
2021/5/4 9:00,125,867,871,3695,0.235723951,324,547,0.087686062,0.148037889
2021/5/4 10:00,110,1020,1025,4308,0.237929434,449,576,0.104224698,0.133704735
2021/5/4 11:00,101,949,950,4675,0.203208556,513,437,0.10973262,0.093475936
2021/5/4 12:00,98,1020,1020,5056,0.201740506,541,479,0.107001582,0.094738924
2021/5/4 13:00,98,823,825,5000,0.165,487,338,0.0974,0.0676
2021/5/4 14:00,110,896,899,5141,0.174868703,540,359,0.10503793,0.069830772
2021/5/4 15:00,109,944,946,5294,0.17869286,543,403,0.102568946,0.076123914
2021/5/4 16:00,105,1043,1049,5918,0.17725583,552,497,0.093274755,0.083981075
2021/5/4 17:00,121,1657,1662,7570,0.219550859,791,871,0.104491413,0.115059445
2021/5/4 18:00,143,2151,2157,8174,0.263885491,1086,1071,0.132860289,0.131025202
2021/5/4 19:00,123,1826,1831,8113,0.225687169,769,1062,0.094786146,0.130901023
2021/5/4 20:00,156,1448,1449,4767,0.303964758,593,856,0.124396895,0.179567862
2021/5/4 21:00,138,1306,1308,4246,0.30805464,203,1105,0.047809703,0.260244936
2021/5/4 22:00,115,1318,1318,4313,0.305587758,95,1223,0.022026432,0.283561326
2021/5/4 23:00,116,1616,1619,4552,0.355667838,57,1562,0.012521968,0.34314587
2021/5/5 0:00,145,1620,1621,5577,0.29065806,41,1580,0.007351623,0.283306437
2021/5/5 1:00,199,1426,1441,8622,0.167130596,39,1402,0.004523312,0.162607284
2021/5/5 2:00,252,1493,1511,11055,0.136680235,23,1488,0.002080507,0.134599729
2021/5/5 3:00,262,1247,1273,10330,0.123233301,26,1247,0.002516941,0.12071636
2021/5/5 4:00,242,1020,1053,7176,0.14673913,16,1037,0.002229654,0.144509476
2021/5/5 5:00,266,973,1005,8122,0.123737996,55,950,0.006771731,0.116966264
2021/5/5 6:00,337,1353,1395,9390,0.1485623,90,1305,0.009584665,0.138977636
2021/5/5 7:00,464,1710,1753,9457,0.185365338,124,1629,0.013111981,0.172253357
2021/5/5 8:00,837,3316,3370,19375,0.173935484,350,3020,0.018064516,0.155870968
2021/5/5 9:00,384,2634,2653,15270,0.173739358,358,2295,0.023444663,0.150294695
2021/5/5 10:00,173,1924,1926,9350,0.205989305,296,1630,0.031657754,0.174331551
2021/5/5 11:00,239,3397,3402,15587,0.218258805,424,2978,0.027202156,0.19105665
2021/5/5 12:00,245,3732,3736,16866,0.221510732,371,3365,0.021996917,0.199513815
2021/5/5 13:00,237,3797,3805,15802,0.240792305,407,3398,0.025756233,0.215036071
2021/5/5 14:00,206,2822,2826,11642,0.242741797,446,2380,0.038309569,0.204432228
2021/5/5 15:00,183,2746,2750,10905,0.2521779,454,2296,0.041632279,0.210545621
2021/5/5 16:00,173,3104,3108,11274,0.275678552,502,2606,0.044527231,0.231151322
2021/5/5 17:00,357,4721,4724,16953,0.278652746,509,4215,0.030024185,0.248628561
2021/5/5 18:00,471,5117,5126,20147,0.25442994,388,4738,0.01925845,0.23517149
2021/5/5 19:00,494,4561,4567,18418,0.247963948,321,4246,0.017428602,0.230535346
2021/5/5 20:00,575,4695,4712,19139,0.246198861,239,4473,0.012487591,0.23371127
2021/5/5 21:00,505,3824,3840,19140,0.200626959,128,3712,0.006687565,0.193939394
2021/5/5 22:00,420,3540,3551,17124,0.207369773,127,3424,0.007416491,0.199953282
2021/5/5 23:00,115,1069,1074,5266,0.203949867,151,923,0.028674516,0.175275351
2021/5/6 0:00,101,843,848,4846,0.174989682,172,676,0.03549319,0.139496492
2021/5/6 1:00,124,952,958,5587,0.171469483,232,726,0.041524969,0.129944514
2021/5/6 2:00,132,952,960,5654,0.169791298,252,708,0.044570216,0.125221082
2021/5/6 3:00,147,974,979,5413,0.18086089,287,692,0.053020506,0.127840384
2021/5/6 4:00,117,953,962,5474,0.175739861,278,684,0.050785532,0.12495433
2021/5/6 5:00,168,962,975,5215,0.18696069,367,608,0.070373921,0.116586769
2021/5/6 6:00,142,1068,1082,5540,0.195306859,372,710,0.067148014,0.128158845
2021/5/6 7:00,162,1170,1179,5815,0.202751505,386,793,0.066380052,0.136371453
2021/5/6 8:00,128,1184,1188,5680,0.20915493,445,743,0.07834507,0.130809859
2021/5/6 9:00,124,1288,1296,5670,0.228571429,516,780,0.091005291,0.137566138
2021/5/6 10:00,115,1436,1440,5591,0.257556788,546,894,0.097656949,0.159899839
2021/5/6 11:00,119,1392,1394,5500,0.253454545,482,912,0.087636364,0.165818182
2021/5/6 12:00,116,1555,1556,6252,0.248880358,431,1125,0.06893794,0.179942418
2021/5/6 13:00,117,1815,1821,6993,0.26040326,408,1413,0.058344058,0.202059202
2021/5/6 14:00,128,2014,2021,7932,0.254790721,401,1620,0.050554715,0.204236006
2021/5/6 15:00,148,2335,2339,9237,0.253220743,346,1993,0.037458049,0.215762694
2021/5/6 16:00,246,2961,2967,11798,0.251483302,525,2442,0.044499068,0.206984235
2021/5/6 17:00,208,2060,2066,7957,0.259645595,460,1606,0.057810733,0.201834862
2021/5/6 18:00,222,2494,2499,9067,0.275614867,603,1896,0.066504908,0.209109959
2021/5/6 19:00,217,2544,2548,9384,0.271526002,468,2080,0.049872123,0.221653879
2021/5/6 20:00,256,3746,3750,12159,0.308413521,423,3327,0.034789045,0.273624476
2021/5/6 21:00,194,3874,3876,13814,0.280584914,275,3601,0.01990734,0.260677573
2021/5/6 22:00,190,3345,3354,12447,0.269462521,260,3094,0.020888568,0.248573954
2021/5/6 23:00,218,3060,3063,11404,0.268589968,202,2861,0.017713083,0.250876885
2021/5/7 0:00,163,2964,2964,10600,0.279622642,216,2748,0.020377358,0.259245283
2021/5/7 1:00,141,2505,2507,9232,0.271555459,205,2302,0.022205373,0.249350087
2021/5/7 2:00,204,2702,2705,9795,0.276161307,208,2497,0.021235324,0.254925983
2021/5/7 3:00,200,2400,2403,8939,0.268822016,250,2153,0.027967334,0.240854682
2021/5/7 4:00,165,1899,1902,7662,0.248238058,159,1743,0.020751762,0.227486296
2021/5/7 5:00,152,1600,1607,7425,0.216430976,132,1475,0.017777778,0.198653199
2021/5/7 6:00,167,1466,1471,7009,0.20987302,136,1335,0.019403624,0.190469396
2021/5/7 7:00,217,1553,1556,7403,0.21018506,253,1303,0.034175334,0.176009726
2021/5/7 8:00,161,1535,1540,7277,0.21162567,222,1318,0.030507077,0.181118593
2021/5/7 9:00,175,1930,1936,8559,0.226194649,281,1655,0.032830938,0.193363711
2021/5/7 10:00,153,2078,2081,9254,0.224875729,353,1728,0.038145667,0.186730063
2021/5/7 11:00,148,2514,2517,10412,0.2417403,359,2158,0.034479447,0.207260853
2021/5/7 12:00,174,2872,2874,12644,0.227301487,387,2487,0.030607403,0.196694084
2021/5/7 13:00,243,3168,3171,15327,0.206889802,562,2609,0.036667319,0.170222483
2021/5/7 14:00,218,2601,2604,12150,0.214320988,462,2142,0.038024691,0.176296296
2021/5/7 15:00,381,2414,2453,12235,0.200490396,460,1993,0.037597058,0.162893339
2021/5/7 16:00,374,2448,2495,12046,0.207122696,515,1980,0.042752781,0.164369915
2021/5/7 17:00,237,2715,2719,9437,0.288121225,489,2230,0.051817315,0.23630391
2021/5/7 18:00,394,3820,3827,12021,0.318359537,847,2980,0.070460028,0.247899509
2021/5/7 19:00,389,4247,4254,13557,0.313786236,967,3287,0.071328465,0.242457771
2021/5/7 20:00,445,3720,3729,12650,0.294782609,1182,2547,0.093438735,0.201343874
2021/5/7 21:00,347,2877,2887,11397,0.253312275,764,2123,0.067035185,0.18627709
2021/5/7 22:00,344,2781,2791,10652,0.262016523,571,2220,0.053604957,0.208411566
2021/5/7 23:00,358,2874,2881,11017,0.261504947,381,2500,0.034582917,0.22692203
2021/5/8 0:00,333,2678,2686,10697,0.251098439,424,2262,0.039637281,0.211461157
2021/5/8 1:00,325,2655,2664,9373,0.284220634,456,2208,0.048650379,0.235570255
2021/5/8 2:00,279,2120,2126,7839,0.271208062,363,1763,0.046306927,0.224901135
2021/5/8 3:00,225,1389,1401,6219,0.225277376,223,1178,0.035857855,0.189419521
2021/5/8 4:00,230,1136,1143,5418,0.210963455,213,930,0.0393134,0.171650055
2021/5/8 5:00,193,883,887,4430,0.200225734,142,745,0.032054176,0.168171558
2021/5/8 6:00,207,924,934,4397,0.212417557,130,804,0.029565613,0.182851945
2021/5/8 7:00,368,1736,1745,6992,0.249570938,385,1360,0.055062929,0.194508009
2021/5/8 8:00,391,2050,2062,8287,0.248823458,581,1481,0.070109811,0.178713648
2021/5/8 9:00,197,1170,1178,4686,0.251387111,534,644,0.113956466,0.137430644
2021/5/8 10:00,143,850,857,3843,0.223002862,320,537,0.08326828,0.139734582
2021/5/8 11:00,110,796,801,4414,0.181468056,223,578,0.050521069,0.130946987
2021/5/8 12:00,141,942,947,5325,0.177840376,215,732,0.040375587,0.137464789
2021/5/8 13:00,165,983,986,5400,0.182592593,158,828,0.029259259,0.153333333
2021/5/8 14:00,209,1118,1122,5116,0.219311962,152,970,0.029710711,0.189601251
2021/5/8 15:00,220,1363,1371,5366,0.255497577,232,1139,0.043235184,0.212262393
2021/5/8 16:00,225,1720,1725,5986,0.288172402,303,1422,0.050618109,0.237554293
2021/5/8 17:00,166,1734,1739,6070,0.286490939,382,1357,0.062932455,0.223558484
2021/5/8 18:00,193,1404,1412,5637,0.250487848,291,1121,0.051623204,0.198864644
2021/5/8 19:00,219,1629,1636,6515,0.251112817,316,1320,0.048503454,0.202609363
2021/5/8 20:00,355,3565,3572,12276,0.290974259,586,2986,0.047735419,0.24323884
2021/5/8 21:00,361,3843,3857,13038,0.295827581,490,3367,0.037582451,0.25824513
2021/5/8 22:00,297,3102,3105,12455,0.249297471,627,2478,0.050341228,0.198956242
2021/5/8 23:00,327,3207,3209,12195,0.263140631,650,2559,0.053300533,0.209840098
2021/5/9 0:00,355,2462,2468,9294,0.265547665,513,1955,0.055196901,0.210350764
2021/5/9 1:00,325,2917,2920,10378,0.281364425,478,2442,0.046058971,0.235305454
2021/5/9 2:00,340,2436,2437,9029,0.269908074,462,1975,0.051168457,0.218739617
2021/5/9 3:00,259,1689,1694,7058,0.240011335,327,1367,0.046330405,0.193680929
2021/5/9 4:00,252,1484,1488,6563,0.226725583,257,1231,0.039158921,0.187566662
2021/5/9 5:00,295,1615,1617,6755,0.239378238,311,1306,0.04603997,0.193338268
2021/5/9 6:00,317,1706,1709,6586,0.259489827,389,1320,0.059064683,0.200425144
2021/5/9 7:00,275,1663,1667,7615,0.218910046,373,1294,0.048982272,0.169927774
2021/5/9 8:00,190,1539,1541,6930,0.222366522,592,949,0.085425685,0.136940837
2021/5/9 9:00,100,1081,1083,4892,0.221381848,386,697,0.078904334,0.142477514
2021/5/9 10:00,127,998,1002,4798,0.208837015,254,748,0.052938724,0.155898291
2021/5/9 11:00,144,1156,1159,5199,0.222927486,284,875,0.05462589,0.168301596
2021/5/9 12:00,142,1076,1079,5093,0.211859415,257,822,0.050461418,0.161397997
2021/5/9 13:00,128,923,926,4595,0.201523395,178,748,0.038737758,0.162785637
2021/5/9 14:00,127,945,949,4341,0.218613223,216,733,0.04975812,0.168855103
2021/5/9 15:00,150,1329,1330,4980,0.267068273,305,1025,0.06124498,0.205823293
2021/5/9 16:00,184,1755,1763,6455,0.273121611,419,1344,0.064910922,0.208210689
2021/5/9 17:00,184,1386,1391,5598,0.248481601,330,1061,0.058949625,0.189531976
2021/5/9 18:00,247,2097,2102,7964,0.26393772,590,1512,0.074083375,0.189854345
2021/5/9 19:00,339,3324,3334,12301,0.271034875,585,2749,0.047557109,0.223477766
2021/5/9 20:00,298,2590,2605,10970,0.237465816,475,2130,0.043299909,0.194165907
2021/5/9 21:00,322,2571,2578,10346,0.249178426,469,2109,0.045331529,0.203846897
2021/5/9 22:00,282,2534,2535,9995,0.253626813,761,1774,0.076138069,0.177488744
2021/5/9 23:00,260,1966,1968,7942,0.247796525,655,1313,0.082472929,0.165323596
2021/5/10 0:00,292,1923,1928,7544,0.255567338,584,1344,0.077412513,0.178154825
2021/5/10 1:00,230,1451,1458,6461,0.225661662,437,1021,0.067636589,0.158025074
2021/5/10 2:00,91,712,714,3563,0.200392927,233,481,0.065394331,0.134998597
2021/5/10 3:00,64,376,378,2084,0.181381958,148,230,0.071017274,0.110364683
2021/5/10 4:00,59,373,375,2006,0.186939182,160,215,0.079760718,0.107178465
2021/5/10 5:00,47,283,286,1708,0.167447307,111,175,0.06498829,0.102459016
2021/5/10 6:00,57,299,302,1557,0.193962749,125,177,0.080282595,0.113680154
2021/5/10 7:00,25,205,205,1177,0.174171623,90,115,0.07646559,0.097706032
2021/5/10 8:00,40,262,263,1473,0.178547183,109,154,0.073998642,0.10454854
2021/5/10 9:00,32,268,269,1738,0.154775604,112,157,0.064441887,0.090333717
2021/5/10 10:00,52,356,357,2252,0.158525755,174,183,0.077264654,0.081261101
2021/5/10 11:00,50,506,507,2399,0.211338058,215,292,0.089620675,0.121717382
2021/5/10 12:00,44,464,465,2283,0.203679369,156,309,0.068331143,0.135348226
2021/5/10 13:00,35,441,443,2219,0.199639477,153,290,0.068949977,0.1306895
2021/5/10 14:00,34,485,488,2197,0.222121074,185,303,0.084205735,0.137915339
2021/5/10 15:00,40,652,654,2556,0.255868545,245,409,0.095852895,0.160015649
2021/5/10 16:00,58,783,784,2844,0.275668073,303,481,0.106540084,0.169127989
2021/5/10 17:00,68,929,932,3723,0.250335751,283,649,0.076013967,0.174321784
2021/5/10 18:00,69,747,749,3377,0.221794492,293,456,0.086763399,0.135031093
2021/5/10 19:00,66,1321,1323,4715,0.280593849,427,896,0.090562036,0.190031813
2021/5/10 20:00,109,1462,1466,4645,0.315608181,399,1067,0.085898816,0.229709365
2021/5/10 21:00,130,1039,1041,4502,0.231230564,332,709,0.073745002,0.157485562
2021/5/10 22:00,73,817,821,3279,0.250381214,241,580,0.073498018,0.176883196
2021/5/10 23:00,66,520,521,2543,0.204876131,196,325,0.077074322,0.127801809
2021/5/11 0:00,54,571,574,2796,0.205293276,210,364,0.075107296,0.13018598
2021/5/11 1:00,45,498,498,2711,0.183696053,176,322,0.064920693,0.11877536
2021/5/11 2:00,45,417,417,2352,0.177295918,135,282,0.057397959,0.119897959
2021/5/11 3:00,53,382,384,2456,0.156351792,138,246,0.056188925,0.100162866
2021/5/11 4:00,51,369,372,2493,0.14921781,138,234,0.055354994,0.093862816
2021/5/11 5:00,55,435,437,2510,0.174103586,216,221,0.086055777,0.088047809
2021/5/11 6:00,64,447,451,2381,0.189416212,215,236,0.090298194,0.099118018
2021/5/11 7:00,61,410,412,2487,0.165661439,207,205,0.083232811,0.082428629
2021/5/11 8:00,45,484,489,2879,0.169850643,201,288,0.069815908,0.100034734
2021/5/11 9:00,41,457,458,3039,0.15070747,242,216,0.079631458,0.071076012
2021/5/11 10:00,36,405,405,2487,0.162846803,217,188,0.087253719,0.075593084
2021/5/11 11:00,38,492,492,2711,0.181482848,238,254,0.087790483,0.093692364
2021/5/11 12:00,40,422,422,2629,0.160517307,195,227,0.074172689,0.086344618
2021/5/11 13:00,34,368,369,2528,0.14596519,174,195,0.068829114,0.077136076
2021/5/11 14:00,26,373,373,2369,0.157450401,187,186,0.07893626,0.078514141
2021/5/11 15:00,29,412,412,2475,0.166464646,207,205,0.083636364,0.082828283
2021/5/11 16:00,49,870,873,3754,0.232551945,417,456,0.111081513,0.121470432
2021/5/11 17:00,50,848,851,3656,0.232768053,324,527,0.088621444,0.144146608
2021/5/11 18:00,75,643,652,3449,0.189040302,308,344,0.089301247,0.099739055
2021/5/11 19:00,101,1040,1045,4715,0.221633086,529,516,0.112195122,0.109437964
2021/5/11 20:00,189,2415,2437,8215,0.296652465,859,1578,0.10456482,0.192087645
2021/5/11 21:00,147,2062,2072,6686,0.309901286,931,1141,0.139246186,0.1706551
2021/5/11 22:00,97,1013,1018,3804,0.267613039,469,549,0.123291272,0.144321767
2021/5/11 23:00,84,660,663,3372,0.196619217,308,355,0.091340451,0.105278766
2021/5/12 0:00,110,729,736,3740,0.196791444,311,425,0.08315508,0.113636364
2021/5/12 1:00,180,1024,1027,4866,0.211056309,483,544,0.099260173,0.111796136
2021/5/12 2:00,283,1415,1422,5876,0.242001361,686,736,0.116746086,0.125255276
2021/5/12 3:00,261,1559,1562,6231,0.250682074,796,766,0.127748355,0.122933719
2021/5/12 4:00,222,1376,1384,5595,0.247363718,714,670,0.127613941,0.119749777
2021/5/12 5:00,288,1481,1485,5848,0.253932969,750,735,0.128248974,0.125683995
2021/5/12 6:00,345,1816,1818,6708,0.271019678,915,903,0.136404293,0.134615385
2021/5/12 7:00,224,1262,1265,6192,0.204295866,689,576,0.11127261,0.093023256
2021/5/12 8:00,92,568,570,3856,0.147821577,337,233,0.087396266,0.060425311
2021/5/12 9:00,44,396,396,2737,0.144683961,216,180,0.078918524,0.065765437
2021/5/12 10:00,40,388,389,2634,0.147684131,190,199,0.072133637,0.075550494
2021/5/12 11:00,35,390,392,2590,0.151351351,209,183,0.080694981,0.070656371
2021/5/12 12:00,63,463,463,3079,0.150373498,278,185,0.090289055,0.060084443
2021/5/12 13:00,87,433,435,2649,0.164212911,244,191,0.09211023,0.07210268
2021/5/12 14:00,86,363,375,2269,0.165271045,246,129,0.108417805,0.056853239
2021/5/12 15:00,120,488,499,2706,0.184405026,304,195,0.112342942,0.072062084
2021/5/12 16:00,101,844,849,3132,0.271072797,331,518,0.105683269,0.165389527
2021/5/12 17:00,142,985,1005,3875,0.259354839,490,515,0.126451613,0.132903226
2021/5/12 18:00,192,1070,1099,4215,0.260735469,607,492,0.14400949,0.116725979
2021/5/12 19:00,366,1711,1756,6139,0.286040072,1036,720,0.168757127,0.117282945
2021/5/12 20:00,455,1582,1633,5920,0.275844595,916,717,0.15472973,0.121114865
2021/5/12 21:00,649,2288,2393,7900,0.302911392,1156,1237,0.146329114,0.156582278
2021/5/12 22:00,549,1826,1904,6289,0.302750835,1135,769,0.180473843,0.122276992
2021/5/12 23:00,723,1905,1976,6142,0.32171931,1357,619,0.220937805,0.100781504
2021/5/13 0:00,664,1935,2019,6429,0.31404573,1310,709,0.203764193,0.110281537
2021/5/13 1:00,486,1393,1438,5231,0.274899637,963,475,0.184094819,0.090804817
2021/5/13 2:00,488,1453,1494,5316,0.281038375,1042,452,0.196012039,0.085026336
2021/5/13 3:00,528,1420,1480,5375,0.275348837,1033,447,0.192186047,0.083162791
2021/5/13 4:00,437,1334,1386,5016,0.276315789,1046,340,0.208532695,0.067783094
2021/5/13 5:00,441,1042,1107,4496,0.246218861,755,352,0.167927046,0.078291815
2021/5/13 6:00,548,1344,1415,4840,0.292355372,915,500,0.189049587,0.103305785
2021/5/13 7:00,439,1088,1159,4427,0.261802575,814,345,0.183871696,0.077930879
2021/5/13 8:00,373,1035,1094,4249,0.257472346,679,415,0.159802306,0.09767004
2021/5/13 9:00,348,1061,1104,4319,0.255614726,685,419,0.158601528,0.097013197
2021/5/13 10:00,305,1071,1103,4483,0.246040598,650,453,0.144992193,0.101048405
2021/5/13 11:00,208,876,891,3315,0.268778281,456,435,0.137556561,0.131221719
2021/5/13 12:00,0,0,0,0,NaN,0,0,NaN,NaN
2021/5/13 13:00,0,0,0,0,NaN,0,0,NaN,NaN
2021/5/13 14:00,0,0,0,0,NaN,0,0,NaN,NaN
2021/5/13 15:00,0,0,0,0,NaN,0,0,NaN,NaN
2021/5/13 16:00,0,0,0,0,NaN,0,0,NaN,NaN
2021/5/13 17:00,0,0,0,0,NaN,0,0,NaN,NaN
2021/5/13 18:00,0,0,0,0,NaN,0,0,NaN,NaN
2021/5/13 19:00,0,0,0,0,NaN,0,0,NaN,NaN
2021/5/13 20:00,0,0,0,0,NaN,0,0,NaN,NaN
2021/5/13 21:00,0,0,0,0,NaN,0,0,NaN,NaN
2021/5/13 22:00,0,0,0,0,NaN,0,0,NaN,NaN
2021/5/13 23:00,0,0,0,0,NaN,0,0,NaN,NaN
2021/5/14 0:00,0,0,0,0,NaN,0,0,NaN,NaN
2021/5/14 1:00,0,0,0,0,NaN,0,0,NaN,NaN
2021/5/14 2:00,0,0,0,0,NaN,0,0,NaN,NaN
2021/5/14 3:00,0,0,0,0,NaN,0,0,NaN,NaN
2021/5/14 4:00,0,0,0,0,NaN,0,0,NaN,NaN
2021/5/14 5:00,0,0,0,0,NaN,0,0,NaN,NaN
2021/5/14 6:00,0,0,0,0,NaN,0,0,NaN,NaN
2021/5/14 7:00,0,0,0,0,NaN,0,0,NaN,NaN
2021/5/14 8:00,0,0,0,0,NaN,0,0,NaN,NaN
2021/5/14 9:00,0,0,0,0,NaN,0,0,NaN,NaN
2021/5/14 10:00,0,0,0,0,NaN,0,0,NaN,NaN
2021/5/14 11:00,0,0,0,0,NaN,0,0,NaN,NaN
2021/5/14 12:00,0,0,0,0,NaN,0,0,NaN,NaN
2021/5/14 13:00,0,0,0,0,NaN,0,0,NaN,NaN
2021/5/14 14:00,0,0,0,0,NaN,0,0,NaN,NaN
2021/5/14 15:00,0,0,0,0,NaN,0,0,NaN,NaN
2021/5/14 16:00,0,0,0,0,NaN,0,0,NaN,NaN
2021/5/14 17:00,0,0,0,0,NaN,0,0,NaN,NaN
2021/5/14 18:00,0,0,0,0,NaN,0,0,NaN,NaN
2021/5/14 19:00,0,0,0,0,NaN,0,0,NaN,NaN
2021/5/14 20:00,0,0,0,0,NaN,0,0,NaN,NaN
2021/5/14 21:00,0,0,0,0,NaN,0,0,NaN,NaN
2021/5/14 22:00,0,0,0,0,NaN,0,0,NaN,NaN
2021/5/14 23:00,0,0,0,0,NaN,0,0,NaN,NaN
2021/5/15 0:00,0,0,0,0,NaN,0,0,NaN,NaN
2021/5/15 1:00,0,0,0,0,NaN,0,0,NaN,NaN
2021/5/15 2:00,0,0,0,0,NaN,0,0,NaN,NaN
2021/5/15 3:00,0,0,0,0,NaN,0,0,NaN,NaN
2021/5/15 4:00,0,0,0,0,NaN,0,0,NaN,NaN
2021/5/15 5:00,0,0,0,0,NaN,0,0,NaN,NaN
2021/5/15 6:00,0,0,0,0,NaN,0,0,NaN,NaN
2021/5/15 7:00,0,0,0,0,NaN,0,0,NaN,NaN
2021/5/15 8:00,0,0,0,0,NaN,0,0,NaN,NaN
2021/5/15 9:00,0,0,0,0,NaN,0,0,NaN,NaN
2021/5/15 10:00,0,0,0,0,NaN,0,0,NaN,NaN
2021/5/15 11:00,0,0,0,0,NaN,0,0,NaN,NaN
2021/5/15 12:00,0,0,0,0,NaN,0,0,NaN,NaN
2021/5/15 13:00,0,0,0,0,NaN,0,0,NaN,NaN
2021/5/15 14:00,0,0,0,0,NaN,0,0,NaN,NaN
2021/5/15 15:00,0,0,0,0,NaN,0,0,NaN,NaN
2021/5/15 16:00,0,0,0,0,NaN,0,0,NaN,NaN
2021/5/15 17:00,0,0,0,0,NaN,0,0,NaN,NaN
2021/5/15 18:00,0,0,0,0,NaN,0,0,NaN,NaN
2021/5/15 19:00,0,0,0,0,NaN,0,0,NaN,NaN
2021/5/15 20:00,0,0,0,0,NaN,0,0,NaN,NaN
2021/5/15 21:00,0,0,0,0,NaN,0,0,NaN,NaN
2021/5/15 22:00,0,0,0,0,NaN,0,0,NaN,NaN
2021/5/15 23:00,0,0,0,0,NaN,0,0,NaN,NaN
2021/5/16 0:00,0,0,0,0,NaN,0,0,NaN,NaN
2021/5/16 1:00,0,0,0,0,NaN,0,0,NaN,NaN
2021/5/16 2:00,0,0,0,0,NaN,0,0,NaN,NaN
2021/5/16 3:00,0,0,0,0,NaN,0,0,NaN,NaN
2021/5/16 4:00,0,0,0,0,NaN,0,0,NaN,NaN
2021/5/16 5:00,0,0,0,0,NaN,0,0,NaN,NaN
2021/5/16 6:00,0,0,0,0,NaN,0,0,NaN,NaN
2021/5/16 7:00,0,0,0,0,NaN,0,0,NaN,NaN
2021/5/16 8:00,0,0,0,0,NaN,0,0,NaN,NaN
2021/5/16 9:00,0,0,0,0,NaN,0,0,NaN,NaN
2021/5/16 10:00,0,0,0,0,NaN,0,0,NaN,NaN
2021/5/16 11:00,0,0,0,0,NaN,0,0,NaN,NaN
2021/5/16 12:00,0,0,0,0,NaN,0,0,NaN,NaN
2021/5/16 13:00,0,0,0,0,NaN,0,0,NaN,NaN
2021/5/16 14:00,0,0,0,0,NaN,0,0,NaN,NaN
2021/5/16 15:00,0,0,0,0,NaN,0,0,NaN,NaN
2021/5/16 16:00,0,0,0,0,NaN,0,0,NaN,NaN
2021/5/16 17:00,0,0,0,0,NaN,0,0,NaN,NaN
2021/5/16 18:00,0,0,0,0,NaN,0,0,NaN,NaN
2021/5/16 19:00,0,0,0,0,NaN,0,0,NaN,NaN
2021/5/16 20:00,0,0,0,0,NaN,0,0,NaN,NaN
2021/5/16 21:00,0,0,0,0,NaN,0,0,NaN,NaN
2021/5/16 22:00,0,0,0,0,NaN,0,0,NaN,NaN
2021/5/16 23:00,0,0,0,0,NaN,0,0,NaN,NaN
2021/5/17 0:00,0,0,0,0,NaN,0,0,NaN,NaN
2021/5/17 1:00,0,0,0,0,NaN,0,0,NaN,NaN
2021/5/17 2:00,0,0,0,0,NaN,0,0,NaN,NaN
2021/5/17 3:00,0,0,0,0,NaN,0,0,NaN,NaN
2021/5/17 4:00,0,0,0,0,NaN,0,0,NaN,NaN
2021/5/17 5:00,0,0,0,0,NaN,0,0,NaN,NaN
2021/5/17 6:00,0,0,0,0,NaN,0,0,NaN,NaN
2021/5/17 7:00,0,0,0,0,NaN,0,0,NaN,NaN
2021/5/17 8:00,0,0,0,0,NaN,0,0,NaN,NaN
2021/5/17 9:00,0,0,0,0,NaN,0,0,NaN,NaN
2021/5/17 10:00,0,0,0,0,NaN,0,0,NaN,NaN
2021/5/17 11:00,0,0,0,0,NaN,0,0,NaN,NaN
2021/5/17 12:00,0,0,0,0,NaN,0,0,NaN,NaN
2021/5/17 13:00,0,0,0,0,NaN,0,0,NaN,NaN
2021/5/17 14:00,0,0,0,0,NaN,0,0,NaN,NaN
2021/5/17 15:00,0,0,0,0,NaN,0,0,NaN,NaN
2021/5/17 16:00,0,0,0,0,NaN,0,0,NaN,NaN
2021/5/17 17:00,0,0,0,0,NaN,0,0,NaN,NaN
2021/5/17 18:00,0,0,0,0,NaN,0,0,NaN,NaN
2021/5/17 19:00,0,0,0,0,NaN,0,0,NaN,NaN
2021/5/17 20:00,0,0,0,0,NaN,0,0,NaN,NaN
2021/5/17 21:00,0,0,0,0,NaN,0,0,NaN,NaN
2021/5/17 22:00,0,0,0,0,NaN,0,0,NaN,NaN
2021/5/17 23:00,0,0,0,0,NaN,0,0,NaN,NaN
2021/5/18 0:00,0,0,0,0,NaN,0,0,NaN,NaN
2021/5/18 1:00,0,0,0,0,NaN,0,0,NaN,NaN
2021/5/18 2:00,0,0,0,0,NaN,0,0,NaN,NaN
2021/5/18 3:00,0,0,0,0,NaN,0,0,NaN,NaN
2021/5/18 4:00,0,0,0,0,NaN,0,0,NaN,NaN
2021/5/18 5:00,0,0,0,0,NaN,0,0,NaN,NaN
2021/5/18 6:00,0,0,0,0,NaN,0,0,NaN,NaN
2021/5/18 7:00,0,0,0,0,NaN,0,0,NaN,NaN
2021/5/18 8:00,0,0,0,0,NaN,0,0,NaN,NaN
2021/5/18 9:00,0,0,0,0,NaN,0,0,NaN,NaN
2021/5/18 10:00,0,0,0,0,NaN,0,0,NaN,NaN
2021/5/18 11:00,0,0,0,0,NaN,0,0,NaN,NaN
2021/5/18 12:00,0,0,0,0,NaN,0,0,NaN,NaN
2021/5/18 13:00,0,0,0,0,NaN,0,0,NaN,NaN
2021/5/18 14:00,0,0,0,0,NaN,0,0,NaN,NaN
2021/5/18 15:00,0,0,0,0,NaN,0,0,NaN,NaN
2021/5/18 16:00,0,0,0,0,NaN,0,0,NaN,NaN
2021/5/18 17:00,0,0,0,0,NaN,0,0,NaN,NaN
2021/5/18 18:00,0,0,0,0,NaN,0,0,NaN,NaN
2021/5/18 19:00,0,0,0,0,NaN,0,0,NaN,NaN
2021/5/18 20:00,0,0,0,0,NaN,0,0,NaN,NaN
2021/5/18 21:00,0,0,0,0,NaN,0,0,NaN,NaN
2021/5/18 22:00,0,0,0,0,NaN,0,0,NaN,NaN
2021/5/18 23:00,0,0,0,0,NaN,0,0,NaN,NaN
2021/5/19 0:00,0,0,0,0,NaN,0,0,NaN,NaN
2021/5/19 1:00,0,0,0,0,NaN,0,0,NaN,NaN
2021/5/19 2:00,0,0,0,0,NaN,0,0,NaN,NaN
2021/5/19 3:00,0,0,0,0,NaN,0,0,NaN,NaN
2021/5/19 4:00,0,0,0,0,NaN,0,0,NaN,NaN
2021/5/19 5:00,0,0,0,0,NaN,0,0,NaN,NaN
2021/5/19 6:00,0,0,0,0,NaN,0,0,NaN,NaN
2021/5/19 7:00,0,0,0,0,NaN,0,0,NaN,NaN
2021/5/19 8:00,0,0,0,0,NaN,0,0,NaN,NaN
2021/5/19 9:00,0,0,0,0,NaN,0,0,NaN,NaN
2021/5/19 10:00,0,0,0,0,NaN,0,0,NaN,NaN
2021/5/19 11:00,0,0,0,0,NaN,0,0,NaN,NaN
2021/5/19 12:00,0,0,0,0,NaN,0,0,NaN,NaN
2021/5/19 13:00,0,0,0,0,NaN,0,0,NaN,NaN
2021/5/19 14:00,0,0,0,0,NaN,0,0,NaN,NaN
2021/5/19 15:00,0,0,0,0,NaN,0,0,NaN,NaN
2021/5/19 16:00,0,0,0,0,NaN,0,0,NaN,NaN
2021/5/19 17:00,0,0,0,0,NaN,0,0,NaN,NaN
2021/5/19 18:00,0,0,0,0,NaN,0,0,NaN,NaN
2021/5/19 19:00,0,0,0,0,NaN,0,0,NaN,NaN
2021/5/19 20:00,0,0,0,0,NaN,0,0,NaN,NaN
2021/5/19 21:00,0,0,0,0,NaN,0,0,NaN,NaN
2021/5/19 22:00,0,0,0,0,NaN,0,0,NaN,NaN
2021/5/19 23:00,0,0,0,0,NaN,0,0,NaN,NaN
2021/5/20 0:00,0,0,0,0,NaN,0,0,NaN,NaN
2021/5/20 1:00,0,0,0,0,NaN,0,0,NaN,NaN
2021/5/20 2:00,0,0,0,0,NaN,0,0,NaN,NaN
2021/5/20 3:00,0,0,0,0,NaN,0,0,NaN,NaN
2021/5/20 4:00,0,0,0,0,NaN,0,0,NaN,NaN
2021/5/20 5:00,0,0,0,0,NaN,0,0,NaN,NaN
2021/5/20 6:00,0,0,0,0,NaN,0,0,NaN,NaN
2021/5/20 7:00,0,0,0,0,NaN,0,0,NaN,NaN
2021/5/20 8:00,0,0,0,0,NaN,0,0,NaN,NaN
2021/5/20 9:00,0,0,0,0,NaN,0,0,NaN,NaN
2021/5/20 10:00,0,0,0,0,NaN,0,0,NaN,NaN
2021/5/20 11:00,0,0,0,0,NaN,0,0,NaN,NaN
2021/5/20 12:00,196,1420,1441,7975,0.180689655,820,621,0.102821317,0.077868339
2021/5/20 13:00,493,1312,1466,10918,0.134273676,802,664,0.073456677,0.060816999
2021/5/20 14:00,189,634,682,5259,0.129682449,325,357,0.061798821,0.067883628
2021/5/20 15:00,2,3,3,14,0.214285714,2,1,0.142857143,0.071428571
2021/5/20 16:00,0,2,2,20,0.1,1,1,0.05,0.05
2021/5/20 17:00,1,1,2,16,0.125,1,1,0.0625,0.0625
2021/5/20 18:00,0,3,3,23,0.130434783,0,3,0,0.130434783
2021/5/20 19:00,1,1,1,14,0.071428571,1,0,0.071428571,0
2021/5/20 20:00,3,5,6,15,0.4,2,4,0.133333333,0.266666667
2021/5/20 21:00,3,4,4,12,0.333333333,2,2,0.166666667,0.166666667
2021/5/20 22:00,0,1,1,19,0.052631579,1,0,0.052631579,0
2021/5/20 23:00,0,1,1,12,0.083333333,0,1,0,0.083333333
2021/5/21 0:00,0,0,0,14,0,0,0,0,0
2021/5/21 1:00,0,2,2,16,0.125,1,1,0.0625,0.0625
2021/5/21 2:00,2,4,4,7,0.571428571,3,1,0.428571429,0.142857143
2021/5/21 3:00,0,1,1,13,0.076923077,1,0,0.076923077,0
2021/5/21 4:00,1,1,2,10,0.2,1,1,0.1,0.1
2021/5/21 5:00,0,1,1,8,0.125,0,1,0,0.125
2021/5/21 6:00,0,0,0,4,0,0,0,0,0
2021/5/21 7:00,1,1,1,9,0.111111111,0,1,0,0.111111111
2021/5/21 8:00,1,2,2,7,0.285714286,1,1,0.142857143,0.142857143
2021/5/21 9:00,0,2,2,5,0.4,0,2,0,0.4
2021/5/21 10:00,1,0,1,8,0.125,1,0,0.125,0
2021/5/21 11:00,2,4,4,29,0.137931034,3,1,0.103448276,0.034482759
2021/5/21 12:00,1,2,3,35,0.085714286,2,1,0.057142857,0.028571429
2021/5/21 13:00,23,301,302,5669,0.053272182,102,200,0.017992591,0.035279591
2021/5/21 14:00,119,1322,1328,13514,0.098268462,482,846,0.035666716,0.062601746
2021/5/21 15:00,164,2098,2098,10164,0.206414797,786,1312,0.077331759,0.129083038
2021/5/21 16:00,168,2186,2189,9437,0.231959309,840,1349,0.089011338,0.142947971
2021/5/21 17:00,121,5526,5527,17166,0.321973669,2424,3103,0.141209367,0.180764302
2021/5/21 18:00,200,5309,5311,16498,0.321917808,1926,3385,0.116741423,0.205176385
2021/5/21 19:00,153,6533,6546,21189,0.308933881,2929,3617,0.138232102,0.170701779
2021/5/21 20:00,149,6609,6610,22641,0.291948236,2426,4184,0.107150744,0.184797491
2021/5/21 21:00,222,8980,8980,26378,0.340435211,4609,4371,0.174728941,0.16570627
2021/5/21 22:00,221,3144,3145,13324,0.236040228,1145,2000,0.085935155,0.150105074
2021/5/21 23:00,232,2634,2636,11431,0.230600997,1025,1611,0.089668445,0.140932552
2021/5/22 0:00,220,2214,2217,9988,0.22196636,950,1267,0.095114137,0.126852223
2021/5/22 1:00,149,1858,1860,8654,0.214929512,791,1069,0.09140282,0.123526693
2021/5/22 2:00,195,5178,5181,16423,0.315472204,2104,3077,0.128113012,0.187359191
2021/5/22 3:00,149,3313,3316,12178,0.272294301,1409,1907,0.115700443,0.156593858
2021/5/22 4:00,135,1474,1474,7184,0.205178174,692,782,0.096325167,0.108853007
2021/5/22 5:00,229,1896,1902,9787,0.19433943,826,1076,0.08439767,0.109941759
2021/5/22 6:00,182,1680,1698,8381,0.202601122,1056,642,0.125999284,0.076601837
2021/5/22 7:00,132,1531,1535,6834,0.224612233,813,722,0.118964004,0.105648229
2021/5/22 8:00,138,1466,1468,7343,0.19991829,691,777,0.094103228,0.105815062
2021/5/22 9:00,122,1615,1615,7735,0.208791209,733,882,0.094764059,0.114027149
2021/5/22 10:00,152,1629,1630,7963,0.204696722,688,942,0.086399598,0.118297124
2021/5/22 11:00,136,1321,1323,7616,0.173713235,585,738,0.076811975,0.096901261
2021/5/22 12:00,113,1085,1085,6531,0.166130761,501,584,0.07671107,0.089419691
2021/5/22 13:00,128,1003,1006,6288,0.159987277,515,491,0.081902036,0.078085242
2021/5/22 14:00,123,1120,1121,6246,0.179474864,505,616,0.080851745,0.098623119
2021/5/22 15:00,143,1053,1053,5716,0.184219734,502,551,0.087823653,0.096396081
2021/5/22 16:00,130,1307,1309,5777,0.226588195,589,720,0.101956033,0.124632162
2021/5/22 17:00,187,1865,1867,7769,0.240314069,800,1067,0.102973356,0.137340713
2021/5/22 18:00,149,3104,3104,10412,0.298117557,1055,2049,0.101325394,0.196792163
2021/5/22 19:00,195,3501,3502,11991,0.292052373,1730,1772,0.144274873,0.1477775
2021/5/22 20:00,223,4289,4290,14159,0.302987499,1793,2497,0.126633237,0.176354262
2021/5/22 21:00,245,3736,3738,13757,0.271716217,1601,2137,0.116377117,0.1553391
2021/5/22 22:00,277,4502,4506,15584,0.28914271,2309,2197,0.148164784,0.140977926
2021/5/22 23:00,239,4069,4071,13366,0.304578782,2507,1564,0.187565465,0.117013317
2021/5/23 0:00,239,3844,3845,12874,0.298663974,2139,1706,0.166148827,0.132515147
2021/5/23 1:00,264,4008,4010,15201,0.263798434,1568,2442,0.103151108,0.160647326
2021/5/23 2:00,280,2840,2845,11225,0.253452116,1371,1474,0.122138085,0.131314031
2021/5/23 3:00,262,2570,2576,9088,0.283450704,1394,1182,0.153389085,0.13006162
2021/5/23 4:00,177,2304,2304,7854,0.293353705,1045,1259,0.133053221,0.160300484
2021/5/23 5:00,373,3489,3490,10631,0.328285204,1666,1824,0.156711504,0.1715737
2021/5/23 6:00,322,3555,3555,11247,0.316084289,1421,2134,0.126344803,0.189739486
2021/5/23 7:00,370,4420,4423,12408,0.356463572,1852,2571,0.149258543,0.207205029
2021/5/23 8:00,367,3917,3917,12717,0.308012896,1763,2154,0.138633325,0.169379571
2021/5/23 9:00,302,3275,3275,11542,0.283746318,1253,2022,0.108560042,0.175186276
2021/5/23 10:00,155,2209,2209,9440,0.234004237,855,1354,0.090572034,0.143432203
2021/5/23 11:00,183,2486,2486,10736,0.231557377,974,1512,0.090722802,0.140834575
2021/5/23 12:00,162,2501,2502,10583,0.236416895,767,1735,0.072474724,0.163942171
2021/5/23 13:00,111,1979,1979,9327,0.212179693,646,1333,0.069261284,0.142918409
2021/5/23 14:00,141,2115,2115,9367,0.225792676,946,1169,0.100992847,0.124799829
2021/5/23 15:00,161,2210,2210,8986,0.245938126,862,1348,0.095926998,0.150011128
2021/5/23 16:00,165,4413,4413,13619,0.324032602,1180,3233,0.08664366,0.237388942
2021/5/23 17:00,171,3269,3269,11593,0.281980505,1293,1976,0.111532822,0.170447684
2021/5/23 18:00,168,3789,3790,12890,0.294026377,1472,2318,0.114197052,0.179829325
2021/5/23 19:00,162,3795,3796,12771,0.297235925,1301,2495,0.101871427,0.195364498
2021/5/23 20:00,239,4873,4877,20159,0.241926683,1976,2901,0.098020735,0.143905948
2021/5/23 21:00,276,6162,6162,22613,0.272498121,2446,3716,0.108167868,0.164330253
2021/5/23 22:00,311,6497,6497,27460,0.236598689,1599,4898,0.058230153,0.178368536
2021/5/23 23:00,376,7247,7250,30270,0.239511067,1924,5326,0.063561282,0.175949785
2021/5/24 0:00,403,6629,6630,25346,0.261579736,2792,3838,0.110155449,0.151424288
2021/5/24 1:00,314,5815,5817,20431,0.284714405,3064,2753,0.149968186,0.134746219
2021/5/24 2:00,341,7065,7071,24096,0.293451195,4761,2310,0.197584661,0.095866534
2021/5/24 3:00,409,5834,5839,19226,0.303703318,3069,2770,0.159627588,0.144075731
2021/5/24 4:00,341,4341,4348,14639,0.297014823,2086,2262,0.142496072,0.154518751
2021/5/24 5:00,306,3179,3184,11426,0.278662699,1694,1490,0.148258358,0.130404341
2021/5/24 6:00,310,3993,3995,13665,0.292352726,1992,2003,0.145773875,0.146578851
2021/5/24 7:00,270,3702,3704,12679,0.292136604,1775,1929,0.139995268,0.152141336
2021/5/24 8:00,320,4074,4076,14363,0.283784725,1798,2278,0.125182761,0.158601963
2021/5/24 9:00,368,5634,5636,21369,0.263746549,2246,3390,0.105105527,0.158641022
2021/5/24 10:00,463,4572,4583,23123,0.198200925,1581,3002,0.068373481,0.129827445
2021/5/24 11:00,587,5650,5668,39476,0.14358091,1430,4238,0.036224541,0.107356368
2021/5/24 12:00,488,4575,4592,22619,0.203015164,1559,3033,0.068924356,0.134090809
2021/5/24 13:00,514,3850,3871,19064,0.203052875,1157,2714,0.060690306,0.142362568
2021/5/24 14:00,517,4504,4521,20626,0.219189373,1476,3045,0.071560167,0.147629206
2021/5/24 15:00,672,5117,5137,22990,0.223444976,1663,3474,0.072335798,0.151109178
2021/5/24 16:00,745,5599,5625,21982,0.255891184,1829,3796,0.08320444,0.172686744
2021/5/24 17:00,829,5630,5663,23850,0.237442348,2042,3621,0.085618449,0.151823899
2021/5/24 18:00,809,7397,7433,36209,0.205280455,2060,5373,0.056891933,0.148388522
2021/5/24 19:00,535,6024,6043,28659,0.210858718,1782,4261,0.06217942,0.148679298
2021/5/24 20:00,772,7064,7095,31249,0.227047266,1965,5130,0.062882012,0.164165253
2021/5/24 21:00,1045,8842,8897,34544,0.257555581,2409,6488,0.069737147,0.187818434
2021/5/24 22:00,1370,10006,10061,36485,0.27575716,3297,6764,0.090365904,0.185391257
2021/5/24 23:00,850,9234,9236,31661,0.29171536,2812,6424,0.088815893,0.202899466
2021/5/25 0:00,702,8145,8149,29589,0.275406401,2033,6116,0.068707966,0.206698435
2021/5/25 1:00,660,7766,7772,29288,0.265364654,1960,5812,0.066921606,0.198443048
2021/5/25 2:00,614,7786,7791,27271,0.285688094,2062,5729,0.075611455,0.210076638
2021/5/25 3:00,698,7895,7897,26295,0.300323255,2507,5390,0.09534132,0.204981936
2021/5/25 4:00,685,8405,8406,27047,0.310792324,2542,5864,0.093984545,0.216807779
2021/5/25 5:00,535,8596,8599,29714,0.289392206,1937,6662,0.065188127,0.224204079
2021/5/25 6:00,294,6211,6214,32810,0.189393478,704,5510,0.021456873,0.167936605
2021/5/25 7:00,278,4391,4398,28611,0.153717102,587,3811,0.020516585,0.133200517
2021/5/25 8:00,278,3058,3064,26847,0.114128208,391,2673,0.014564011,0.099564197
2021/5/25 9:00,265,3717,3718,30185,0.123173762,458,3260,0.015173099,0.108000663
2021/5/25 10:00,296,5086,5088,28419,0.179035153,804,4284,0.028290932,0.15074422
2021/5/25 11:00,270,4086,4089,20393,0.200509979,726,3363,0.035600451,0.164909528
2021/5/25 12:00,318,3891,3895,21209,0.183648451,722,3173,0.034042152,0.149606299
2021/5/25 13:00,506,4789,4795,27679,0.173236027,965,3830,0.034863976,0.138372051
2021/5/25 14:00,344,3857,3864,25950,0.148901734,718,3146,0.027668593,0.121233141
2021/5/25 15:00,377,5188,5193,26063,0.199247976,893,4300,0.034263132,0.164984844
2021/5/25 16:00,294,5602,5605,24890,0.22519084,658,4947,0.02643632,0.19875452
2021/5/25 17:00,418,10698,10703,34468,0.310519903,1733,8970,0.050278519,0.260241383
2021/5/25 18:00,441,9365,9368,29474,0.317839452,1351,8017,0.045837009,0.272002443
2021/5/25 19:00,610,7958,7961,28011,0.284209775,1917,6044,0.0684374,0.215772375
2021/5/25 20:00,301,6108,6109,26179,0.233354979,1058,5051,0.040414072,0.192940907
2021/5/25 21:00,198,5267,5267,26452,0.199115379,723,4544,0.027332527,0.171782852
2021/5/25 22:00,329,5919,5919,29269,0.202227613,935,4984,0.031945061,0.170282552
2021/5/25 23:00,349,7454,7455,33101,0.225219782,1005,6450,0.03036162,0.194858161
2021/5/26 0:00,248,7730,7731,31729,0.243657222,982,6749,0.030949604,0.212707618
2021/5/26 1:00,234,6352,6352,26002,0.244288901,920,5432,0.035381894,0.208907007
2021/5/26 2:00,361,6841,6844,28555,0.239677815,1108,5736,0.038802311,0.200875503
2021/5/26 3:00,363,7177,7180,28432,0.252532358,1292,5888,0.045441756,0.207090602
2021/5/26 4:00,318,6400,6407,26952,0.237718908,916,5491,0.033986346,0.203732562
2021/5/26 5:00,357,6067,6069,25530,0.237720329,987,5082,0.0386604,0.199059929
2021/5/26 6:00,424,5795,5797,23525,0.246418704,1326,4471,0.056365569,0.190053135
2021/5/26 7:00,413,4957,4958,18964,0.261442734,1484,3474,0.078253533,0.183189201
2021/5/26 8:00,307,3852,3853,13448,0.286511005,1452,2401,0.107971446,0.17853956
2021/5/26 9:00,221,3265,3267,14819,0.22046022,1003,2264,0.067683379,0.152776841
2021/5/26 10:00,279,3862,3864,17160,0.225174825,934,2930,0.054428904,0.170745921
2021/5/26 11:00,134,1983,1984,11448,0.173305381,566,1418,0.04944095,0.12386443
2021/5/26 12:00,172,1959,1959,11037,0.177493884,762,1197,0.0690405,0.108453384
2021/5/26 13:00,82,1391,1392,8387,0.165971146,485,907,0.05782759,0.108143556
2021/5/26 14:00,140,1682,1682,10128,0.16607425,605,1077,0.059735387,0.106338863
2021/5/26 15:00,303,3498,3501,16911,0.207025013,1178,2323,0.069658802,0.137366211
2021/5/26 16:00,218,7950,7951,24207,0.32845871,3227,4724,0.133308547,0.195150163
2021/5/26 17:00,194,5392,5393,18771,0.287304885,2195,3198,0.116935699,0.170369187
2021/5/26 18:00,224,6530,6530,20889,0.31260472,2353,4177,0.112643018,0.199961702
2021/5/26 19:00,171,8366,8368,24660,0.339334955,3222,5146,0.130656934,0.208678021
2021/5/26 20:00,117,8983,8984,27852,0.322562114,3468,5516,0.124515295,0.198046819
2021/5/26 21:00,157,9555,9558,29411,0.324980449,4251,5307,0.144537758,0.180442692
2021/5/26 22:00,277,7205,7206,22042,0.326921332,2912,4294,0.132111424,0.194809908
2021/5/26 23:00,299,5176,5177,19177,0.269958805,1758,3419,0.091672316,0.178286489
2021/5/27 0:00,278,5276,5276,19263,0.273892955,1829,3447,0.094948866,0.17894409
2021/5/27 1:00,209,7043,7044,24615,0.286166971,2000,5044,0.08125127,0.204915702
2021/5/27 2:00,189,5692,5693,20599,0.276372639,1815,3878,0.088111073,0.188261566
2021/5/27 3:00,205,4165,4167,15464,0.269464563,1507,2660,0.097452147,0.172012416
2021/5/27 4:00,212,3503,3505,13694,0.255951512,1444,2061,0.105447641,0.15050387
2021/5/27 5:00,291,3317,3320,12789,0.259598092,1707,1613,0.133474079,0.126124013
2021/5/27 6:00,257,3096,3098,11410,0.271516214,1507,1591,0.132077125,0.139439089
2021/5/27 7:00,326,4099,4100,13459,0.304628873,1657,2443,0.123114644,0.181514228
2021/5/27 8:00,341,3666,3667,14539,0.252218172,1434,2233,0.098631268,0.153586904
2021/5/27 9:00,340,4230,4231,17864,0.236845052,1334,2897,0.074675325,0.162169727
2021/5/27 10:00,264,3293,3293,13593,0.242257044,1111,2182,0.081733245,0.160523799
2021/5/27 11:00,186,2915,2915,13038,0.223577236,1013,1902,0.077695966,0.14588127
2021/5/27 12:00,197,2496,2496,13441,0.185700469,906,1590,0.067405699,0.11829477
2021/5/27 13:00,105,2074,2074,11473,0.180772248,691,1383,0.060228362,0.120543886
2021/5/27 14:00,120,2595,2595,11573,0.224228808,993,1602,0.085803163,0.138425646
2021/5/27 15:00,165,3144,3146,12828,0.245244777,997,2149,0.077720611,0.167524166
2021/5/27 16:00,246,2914,2915,13319,0.218860275,856,2059,0.064269089,0.154591186
2021/5/27 17:00,165,3938,3939,15294,0.257551981,1275,2664,0.083366026,0.174185955
2021/5/27 18:00,137,4183,4183,16948,0.246813783,1566,2617,0.092400283,0.1544135
2021/5/27 19:00,141,7075,7075,21572,0.327971444,2728,4347,0.126460226,0.201511218
2021/5/27 20:00,227,7478,7478,24525,0.304913354,2493,4985,0.101651376,0.203261978
2021/5/27 21:00,232,9949,9949,30808,0.322935601,3940,6009,0.12788886,0.195046741
2021/5/27 22:00,299,10370,10372,32178,0.322332028,4405,5967,0.136894773,0.185437255
2021/5/27 23:00,240,8237,8238,28071,0.293470129,2546,5692,0.090698586,0.202771544
2021/5/28 0:00,162,7938,7938,25185,0.315187612,2570,5368,0.102044868,0.213142744
2021/5/28 1:00,161,6166,6166,19842,0.310754964,2014,4152,0.101501865,0.209253099
2021/5/28 2:00,202,4536,4536,14717,0.308214989,1884,2652,0.12801522,0.180199769
2021/5/28 3:00,144,4373,4373,15411,0.283758354,1318,3055,0.085523327,0.198235027
2021/5/28 4:00,219,3109,3110,12508,0.24864087,1141,1969,0.091221618,0.157419252
2021/5/28 5:00,204,2577,2577,10539,0.244520353,1069,1508,0.101432774,0.143087579
2021/5/28 6:00,273,2788,2790,10765,0.259173247,915,1875,0.084997678,0.174175569
2021/5/28 7:00,335,3698,3699,13303,0.278057581,1216,2483,0.091407953,0.186649628
2021/5/28 8:00,304,3931,3931,14683,0.267724579,1228,2703,0.083634135,0.184090445
2021/5/28 9:00,305,3992,3993,16005,0.249484536,1222,2771,0.07635114,0.173133396
2021/5/28 10:00,260,3145,3145,13534,0.232377715,1037,2108,0.076621841,0.155755874
2021/5/28 11:00,223,2622,2622,12754,0.205582562,952,1670,0.074643249,0.130939313
2021/5/28 12:00,192,2048,2049,11663,0.175683786,810,1239,0.069450399,0.106233388
2021/5/28 13:00,138,1535,1538,9772,0.157388457,563,975,0.05761359,0.099774867
2021/5/28 14:00,168,1691,1692,9102,0.18589321,654,1038,0.07185234,0.11404087
2021/5/28 15:00,206,1952,1952,10132,0.192656929,678,1274,0.0669167,0.125740229
2021/5/28 16:00,230,3535,3539,14605,0.242314276,1460,2079,0.099965765,0.142348511
2021/5/28 17:00,182,6337,6338,21276,0.297894341,2653,3685,0.124694491,0.17319985
2021/5/28 18:00,157,6151,6151,20237,0.303948214,2390,3761,0.118100509,0.185847705
2021/5/28 19:00,178,6813,6813,23565,0.289115213,2619,4194,0.111139402,0.177975812
2021/5/28 20:00,200,7211,7214,25373,0.284317976,3019,4195,0.118984748,0.165333228
2021/5/28 21:00,200,9275,9280,29011,0.319878667,4499,4781,0.155079108,0.164799559
2021/5/28 22:00,224,9094,9096,27597,0.329601044,3574,5522,0.12950683,0.200094213
2021/5/28 23:00,144,11738,11738,33833,0.346939379,4635,7103,0.136996424,0.209942955
2021/5/29 0:00,190,12671,12672,36514,0.347044969,4878,7794,0.133592595,0.213452374
2021/5/29 1:00,123,10639,10639,30266,0.351516553,2985,7654,0.09862552,0.252891033
2021/5/29 2:00,110,6690,6690,22198,0.301378503,1663,5027,0.074916659,0.226461843
2021/5/29 3:00,158,3227,3227,13481,0.239373934,1065,2162,0.079000074,0.16037386
2021/5/29 4:00,203,2923,2925,12500,0.234,1028,1897,0.08224,0.15176
2021/5/29 5:00,213,2496,2499,11091,0.225317825,1041,1458,0.093859886,0.131457939
2021/5/29 6:00,234,3057,3059,12437,0.245959637,1393,1666,0.112004503,0.133955134
2021/5/29 7:00,259,2957,2958,11858,0.249451847,1114,1844,0.093945016,0.155506831
2021/5/29 8:00,329,3275,3275,13490,0.242772424,1153,2122,0.085470719,0.157301705
2021/5/29 9:00,347,3067,3067,14653,0.209308674,1165,1902,0.079505903,0.129802771
2021/5/29 10:00,206,2386,2387,10697,0.223146677,966,1421,0.090305693,0.132840983
2021/5/29 11:00,221,2115,2115,10092,0.209571938,788,1327,0.078081649,0.131490289
2021/5/29 12:00,152,1784,1784,8907,0.200291905,670,1114,0.075221736,0.12507017
2021/5/29 13:00,81,1257,1257,7495,0.167711808,457,800,0.060973983,0.106737825
2021/5/29 14:00,123,1338,1340,7295,0.183687457,502,838,0.068814256,0.114873201
2021/5/29 15:00,138,1524,1525,8373,0.182133047,578,947,0.06903141,0.113101636
2021/5/29 16:00,136,1627,1627,8961,0.181564558,600,1027,0.066956813,0.114607745
2021/5/29 17:00,187,3330,3332,14221,0.234301385,1359,1973,0.0955629,0.138738485
2021/5/29 18:00,147,6021,6021,19573,0.307617637,2209,3812,0.112859551,0.194758085
2021/5/29 19:00,176,6977,6977,22133,0.315230651,2644,4333,0.11945963,0.195771021
2021/5/29 20:00,183,7414,7414,24245,0.305795009,2579,4835,0.106372448,0.199422561
2021/5/29 21:00,145,6691,6691,21074,0.317500237,2832,3859,0.134383601,0.183116637
2021/5/29 22:00,160,7117,7118,23751,0.299692645,2678,4440,0.112753147,0.186939497
2021/5/29 23:00,136,8055,8057,25114,0.320817074,2215,5842,0.088197818,0.232619256
2021/5/30 0:00,109,8183,8184,24702,0.331309206,2004,6180,0.081127034,0.250182171
2021/5/30 1:00,113,6247,6248,20776,0.300731613,1540,4708,0.074123989,0.226607624
2021/5/30 2:00,109,5386,5386,17741,0.303590553,1328,4058,0.074854856,0.228735697
2021/5/30 3:00,105,2848,2849,11527,0.247158844,771,2078,0.066886441,0.180272404
2021/5/30 4:00,116,2169,2169,10161,0.213463242,555,1614,0.054620608,0.158842634
2021/5/30 5:00,121,2196,2196,9373,0.234289982,780,1416,0.083217753,0.151072229
2021/5/30 6:00,149,2587,2589,9875,0.262177215,997,1592,0.100962025,0.16121519
2021/5/30 7:00,190,2863,2864,10283,0.278517942,1128,1736,0.109695614,0.168822328
2021/5/30 8:00,199,2909,2910,11050,0.263348416,1193,1717,0.107963801,0.155384615
2021/5/30 9:00,176,2710,2710,11199,0.241985892,893,1817,0.079739262,0.162246629
2021/5/30 10:00,156,2971,2971,11583,0.25649659,879,2092,0.075887076,0.180609514
2021/5/30 11:00,144,2486,2487,10504,0.236766946,860,1627,0.081873572,0.154893374
2021/5/30 12:00,128,2517,2517,10319,0.243918984,899,1618,0.087120845,0.156798139
2021/5/30 13:00,70,2563,2563,10209,0.251052992,799,1764,0.078264277,0.172788716
2021/5/30 14:00,94,2864,2864,11059,0.258974591,878,1986,0.07939235,0.179582241
2021/5/30 15:00,81,3100,3100,11228,0.276095476,934,2166,0.083184895,0.192910581
2021/5/30 16:00,103,3195,3195,12138,0.263222936,1100,2095,0.090624485,0.172598451
2021/5/30 17:00,143,3275,3275,12433,0.263411888,1064,2211,0.085578702,0.177833186
2021/5/30 18:00,109,3141,3141,11573,0.271407587,1107,2034,0.095653677,0.17575391
2021/5/30 19:00,96,3388,3388,12117,0.279607163,1070,2318,0.088305686,0.191301477
2021/5/30 20:00,126,3961,3964,14536,0.272702256,1238,2726,0.085167859,0.187534397
2021/5/30 21:00,97,3801,3803,13087,0.290593719,1136,2667,0.086803698,0.203790021
2021/5/30 22:00,59,3148,3148,11123,0.283017172,651,2497,0.058527376,0.224489796
2021/5/30 23:00,71,3815,3815,13268,0.287533916,998,2817,0.075218571,0.212315345
2021/5/31 0:00,71,3796,3796,13954,0.272036692,952,2844,0.068224165,0.203812527
2021/5/31 1:00,65,3159,3162,11908,0.265535774,852,2310,0.071548539,0.193987235
2021/5/31 2:00,99,3303,3303,11827,0.279276232,755,2548,0.063836983,0.215439249
2021/5/31 3:00,96,3202,3203,11509,0.278303936,842,2361,0.073160136,0.205143801
2021/5/31 4:00,89,2496,2496,9568,0.260869565,583,1913,0.060932274,0.199937291
2021/5/31 5:00,82,2092,2092,8932,0.234214062,494,1598,0.055306762,0.1789073
2021/5/31 6:00,86,2112,2112,8729,0.241952114,577,1535,0.066101501,0.175850613
2021/5/31 7:00,104,2209,2209,8776,0.251709207,645,1564,0.073495898,0.178213309
2021/5/31 8:00,134,2336,2337,9801,0.238445057,662,1675,0.067544128,0.170900928
2021/5/31 9:00,130,2503,2505,11654,0.214947657,641,1864,0.055002574,0.159945083
2021/5/31 10:00,120,2608,2608,11926,0.218681872,541,2067,0.045363072,0.173318799
2021/5/31 11:00,120,2349,2349,10751,0.218491303,636,1713,0.059157288,0.159334015
2021/5/31 12:00,100,1960,1961,8805,0.222714367,649,1312,0.07370812,0.149006246
2021/5/31 13:00,83,1761,1761,8235,0.213843352,620,1141,0.075288403,0.138554948
2021/5/31 14:00,59,2176,2176,8602,0.252964427,714,1462,0.083003953,0.169960474
2021/5/31 15:00,60,2119,2119,10683,0.198352523,513,1606,0.048020219,0.150332304
2021/5/31 16:00,74,2127,2127,14305,0.148689269,247,1880,0.01726669,0.13142258
2021/5/31 17:00,97,2128,2130,16202,0.131465251,339,1791,0.020923343,0.110541908
2021/5/31 18:00,95,2784,2785,10404,0.267685506,603,2182,0.057958478,0.209727028
2021/5/31 19:00,177,5322,5322,16019,0.332230476,1313,4009,0.081965166,0.25026531
2021/5/31 20:00,201,6152,6152,21889,0.281054411,985,5167,0.044999772,0.236054639
2021/5/31 21:00,239,6204,6204,28249,0.219618394,565,5639,0.020000708,0.199617686
2021/5/31 22:00,251,6665,6665,30183,0.220819667,760,5905,0.025179737,0.19563993
2021/5/31 23:00,264,11692,11692,47368,0.246833305,774,10918,0.016340145,0.23049316
